XXXXXXXXXXXXXXX
X     X       X
X XXX X XXXXX X
X X   X     X X
X X XXXXXXX X X
X X       X X X
X XXXXXXX X X X
X       X X   X
XXXXX X X XXX X
X     X X     X
X XXXXX XXXXXXX
X     X       X
XXX X XXXXX X X
X   X       X X
XXXXXXXXXXXXXXX
